NO textures/neon/neon_broken_wall.xpm42
WE /home/jeandrad/Desktop/cub3d/textures/neon/neon_broken_wall2.xpm42
SO /home/jeandrad/Desktop/cub3d/textures/neon/neon_broken_wall2.xpm42
EA textures/neon/neon_broken_wall.xpm42
F 176,224,230
C 138,43,226
1111111111
1000000001
1000000001
1000N00001
1000000001
1000S00001
1000000001
1000E00001
1000000001
1111111111