NO ./textures/neon_wall2.xpm42
WE ./textures/purplestone.xpm42
SO ./textures/bluestone.xpm42
EA ./textures/wood.xpm42

F 176,224,230
C 138,43,226


11111111111111111111111111111111111111
1100000000000000000000000000000000000111
111111111111111100000000000000000000111
          111 111111111111110000000001
          1111111111111111110000000011
          10000000000000000000000000001
 111111111100000000000000000000000000011
1000000000000000000000000000000N000000001
110000000000000000000000000000000000000001
100000000000000000000000000000000000000001
111111111111111111111111111111111111111111
100000000000000000000000000000000000000001
111111111111111111111111111111111111111111