# **************************************************************************** #
#                                                                              #
#                                                         :::      ::::::::    #
#    Example.cub                                        :+:      :+:    :+:    #
#                                                     +:+ +:+         +:+      #
#    By: cagarci2 <cagarci2@student.42.fr>          +#+  +:+       +#+         #
#                                                 +#+#+#+#+#+   +#+            #
#    Created: 2024/12/04 12:48:29 by cagarci2          #+#    #+#              #
#    Updated: 2024/12/04 12:59:32 by cagarci2         ###   ########.fr        #
#                                                                              #
# **************************************************************************** #

1111111111111111111111111111111111111
1E000000000   00000000000000000000000111
1111111111110000000000000000000000001
          111111111111111111000000001
          111111111111111111000000001
          1000000000000000000000000001
111111111110000000000000000000000000001
10000000000000000000000000000000000000001
100000000000000000000000000000000000000001
1000000000000000000000000000000000000000001
10000000000000000000000000000000000000000001
11111111111111111111111111111111111111111111