F 220,100,0

NO ./Textures/north_texture

WE ./Textures/west_texture
SO ./Textures/south_texture
EA ./Textures/east_texture

C 225,30,0

 1111111111111111111111111111111111111
11E000000001   00000000000000000000000111
11111111111100000000000000000000000011
          111111111111111111000000001
          111111111111111111000000001
          1000000000000000000000000001
1111111111100000000000000000000000000011
10000000000000000000000000000000000000001
100000000000000000000000000000000000000001
1000000000000000000000000000000000000000001
10000000000000000000000000000000000000000001
11111111111111111111111111111111111111111111