
NO ./textures/neon_wall2.xpm42
WE ./textures/purplestone.xpm42
SO ./textures/bluestone.xpm42
EA ./textures/wood.xpm42

F 0,191,255
C 225,30,0

1111111111111111111111111111111111111
1100000000000000000000000000000000000111
111111111111111100000000000000000000111
          11111111111111111100000000E
          1111111111111111110000000001
          1000000000000000000000000001
1111111111100000000000000000000000000011
10000000000000000000000000000000000000001
110000000000000000000000000000000000000001
10000000000000000000000000000000000000001
100000000000000000000000000000000000000001
1111111111111111111111111111111111111111110
