NO ./textures/neon_wall2.xpm42
WE ./textures/purplestone.xpm42
SO ./textures/bluestone.xpm42
EA ./textures/wood.xpm42
F 176,224,230
C 138,43,226

1111111111111
1000000000001
1011000000E01
1000000000001
1111111111111