NO /home/jeandrad/Desktop/cub3d/textures/256x256/256_Cement 01.xpm42
WE textures/256x256/256_Cement 02.xpm42
SO textures/256x256/256_Cement 01.xpm42
EA textures/256x256/256_Cement 04.xpm42
F 169,169,169
C 128,128,128

1111111111111
1000000000001
1011000000E01
1000000000001
1111111111111