1111111111111
1000000000001
1011001000N01
1000010000001
0111111111110