NO textures/256x256/256_Brick 02.xpm
WE textures/256x256/256_Brick 04.xpm
SO textures/256x256/256_Brick 04.xpm
EA textures/256x256/256_Brick 03.xpm

F 210,180,140
C 210,105,30

11111111111111111111
10000000000000000001
10111111111111111001
10100000000000001001
10101111111111101001
10101000000000101001
10101011111110101001
10101010000010101001
10101010111010101001
10101010101010101001
10101010101010101001
10101010101010101001
10101010101010101001
101010101N1010101001
10101010101010101001
10101010101010101001
10101010101010101001
10101010101010101001
10000000000000000001
11111111111111111111





















